1111111111111111111111111111111111
1C00000000000000000000000000000001
10P00000000000000000000000C0000001
1000000000000000000000000000000001
1000000000000000000000000000000001
1000000000000000000000000000000001
1000001000111100000000000000000001
1000001000000000000000000000000001
1000001000000000000000000000000001
1111111000000000000000000011000001
1000000000000011111000000000000001
10000000000000100C1000000000000001
1000000C00000010111111110000001E01
1000001110000010000000000000001001
1111111111111111111111111111111111
