1111111111111111111111111111111111111111111111111111111111111111111111111111
1C00000000000000000000001000000001111111111111111111111111111111111111111111
100000000M000000000000001000000001111111111111111111111111111111111111111111
1000000000000M00000000001111110001111111111111111111111111111111111111111111
100000100M000000000000000000000001111111111111111111111111111111111111111111
100000100000P000000111111000000001111111111111111111111111111111111111111111
1111111111011110000101001000000001111111111111111111111111111111111111111111
1000001000000001000111111000000001111111111111111111111111111111111111111111
1001111000000001000000000000000001111111111111111111111111111111111111111111
1000000001110001000000000011000001111111111111111111111111111111111111111111
1000000000000011111000000000000001111111111111111111111111111111111111111111
1010111111110010001000000000000001111111111111111111111111111111111111111111
1010100000010010111111110000001001111111111111111111111111111111111111111111
1E10001110000010000000000000001001111111111111111111111111111111111111111111
1111111111111111111111111111111111111111111111111111111111111111111111111111
1111111111111111111111111111111111111111111111111111111111111111111111111111
1111111111111111111111111111111111111111111111111111111111111111111111111111
1111111111111111111111111111111111111111111111111111111111111111111111111111
1111111111111111111111111111111111111111111111111111111111111111111111111111
1111111111111111111111111111111111111111111111111111111111111111111111111111
1111111111111111111111111111111111111111111111111111111111111111111111111111
1111111111111111111111111111111111111111111111111111111111111111111111111111
1111111111111111111111111111111111111111111111111111111111111111111111111111
1111111111111111111111111111111111111111111111111111111111111111111111111111
1111111111111111111111111111111111111111111111111111111111111111111111111111
1111111111111111111111111111111111111111111111111111111111111111111111111111
1111111111111111111111111111111111111111111111111111111111111111111111111111
1111111111111111111111111111111111111111111111111111111111111111111111111111
1111111111111111111111111111111111111111111111111111111111111111111111111111
1111111111111111111111111111111111111111111111111111111111111111111111111111
1111111111111111111111111111111111111111111111111111111111111111111111111111
1111111111111111111111111111111111111111111111111111111111111111111111111111
1111111111111111111111111111111111111111111111111111111111111111111111111111
