1111111111111111111111111111111111
1C00000000000000000000001000000001
100000000M000000000000001000000001
1000000000000M00000000001111110001
100000100M000000000000000000000001
100000100000P000000111111000000001
1111111111011110000101001000000001
1000001000000001000111111000000001
1001111000000001000000000000000001
1000000001110001000000000011000001
1000000000000011111000000000000001
1010111111110010001000000000000001
1010100000010010111111110000001001
1E10001110000010000000000000001001
1111111111111111111111111111111111
